Информация всей одежды 12.11.2025

Hat - Шляпа
Neck - Шея
Jacket - Куртка
Backpack - Рюкзак
Pants - Штаны
Belt - Пояс
Shoes - Обувь

55 предмета

-- Комплект игрока -- 15

CapDark - Кепка тёмная
CapLight - Кепка светлая

Tie - Галстук

ShirtDark - Рубашка тёмная
ShirtLight - Рубашка светлая
ShirtCheckered - Рубашка в клетку

BagDark - Сумка темная
BagLight - Сумка светлая

ShortsDark - Шорты тёмные
ShortsLight - Шорты светлые
PantsJeans - Джинсовые брюки

BeltBranded - Фирменный ремень

ShaleRed - Сланцы красные
ShaleBlue - Сланцы синие
BootsBranded - Фирменные ботинки (коричнево-чёрные)

-- Комплект Малювеков -- 21

HatStraw - Соломенная шляпа
BandanaDark - Бандана тёмная
BandanaLight - Бандана светлая

Mascot - Талисман
MascotCarefully - Талисман аккуратно (шёлк)
MascotCarefullyPower - Талисман аккуратно и сила (шёлк)
MascotFortune - Талисман удача (на части)
MascotFortunePower - Талисман удача и сила (на части)
MascotPower - Талисман сила

CapeStraw - Накидка из соломы
ShirtOfRagsDark - Рубашка из тряпок тёмная
ShirtOfRagsLight - Рубашка из тряпок светлая

BackpackStraw - Рюкзак из соломы
BackpackCloth - Рюкзак тряпичный

ShortsStraw - Соломенные шорты
ShortsOfRagsDark - Шорты из тряпок тёмные
ShortsOfRagsLight - Шорты из тряпок светлые

BeltClothDark - Пояс тряпичный тёмный
BeltClothLight - Пояс тряпичный светлый

BastShoes - Лапти
SandalsDark - Сандали тёмные
SandalsLight - Сандали светлые

-- Комплект Браконьеров -- 13

BeretBlack - Берет чёрный
BeretKhaki - Берет хаки

Tablet - Планшет

JacketTacticalBlack - Куртка тактическая чёрная
JacketTacticalKhaki - Куртка тактическая хаки

BackpackTacticalBlack - Рюкзак тактический чёрный
BackpackTacticalKhaki - Рюкзак тактический хаки

PantsTacticalBlack - Брюки тактические чёрные
PantsTacticalKhaki - Брюки тактические хаки

BeltTacticalBlack - Ремень тактический чёрный
BeltTacticalKhaki - Ремень тактический хаки

BootsTacticalBlack - Ботинки тактические чёрные
BootsTacticalKhaki - Ботинки тактические хаки

-- Иное -- 6

HatLeather - Кожаная шляпа

JacketLeather - Кожаная куртка

BackpackLeather - Рюкзак кожаный
BackpackTourist - Рюкзак туристический

PantsLeather - Кожаные штаны

BeltLeather - Кожаный ремень
